111111
1E0001
10PC01
100001
111111