11111111111111111111111111
10000000C00000011110001111
10010111110000000000001111
10010000C0000P000000001111
1001000000000E000000001111
10001111101100000C100000C1
10010000C00000011110001111
10010000000000011110001111
10001111101100000C100000C1
11111111111111111111111111
